WWWWWWWWWWWWWWWWWWWWW
W         W   W     W
W WWW WWW W W WWWWW W
W   W W W   W   W   W
W WWW   WW WWWW W WWW
W W   W     W   W   W
WWW WWW W WWW WWWWW W
W   W W W     W   W W
W WWW W WWW WWW W W W
W W             W   W
WWWWWWWWWWWWWWWWWWWWW