WWWWWWWWWWWWWWWWWWWWWWWWWWWWWWWWW
W         W     W               W
WW WW W WWW W W WWWWWW WWWWWW W W
W   W W W   W W W   W   W   W W W
W W W   W WWW   W W W W   W WWW W
W W W W   W   W   W   W W W   W W
W   WWWW WW WWWW WWWWWW W WWW W W
W W       W W         W   W   W W
W WWWWWWW W   WWWW WW WWWWW WWW W
W W   W W   W   W   W       W   W
W W W   WWWWWWW W W WWWW WWWWWW W
W   W W     W   W W   W   W   W W
W WWW W W W W WWWWW W W W W W W W
W   W   W W W W     W   W   W   W
WW WW W   WWW WWW WWWW WWWWWWWW W
W     W W         W             W
WWWWWWWWWWWWWWWWWWWWWWWWWWWWWWWWW