WWWWWWWWWWWWWWWWWWWWWWWWWWWWWWWW
W W       W    W               W
W W W W W W WW W WW WWW WWWW WWW
W   W W W W W  W W   W   W   W W
W W W   W   WW     W   W   W W W
W W WWW WWWWWW WWWWWWWWW WWWWW W
W W                            W
W WWWW WWW WWW W WWWWWWWWWWW WWW
W      W       W     W         W
W WW WWW WWWWW W WWW W WWWWWWW W
W W      W   W W     W         W
W W WW W W W W WWWWW WWWWWW WWWW
W W  W W W W W W   W W         W
W W WW W W W W W W W W WWWWWWW W
W      W         W             W
WWWWWWWWWWWWWWWWWWWWWWWWWWWWWWWW